###################
#    ##           #
#    O#   @@@@@@  #
#    ## @@@@      #
#   ##     A      #
#     @@@@  ###   #
#  @@@@@          #
#         O       #
###################
